AAAAAAAAAAAAAAAAAAAAAAAAAAAAAAAAAAAAAAAAAAAAAAAAAAAAAAAAAAAAAAAAAAAAAAAAAAAAAAAAAAAAAAAAAAAAAAAAAAAAAAAAAAAAAA.R..........R...A.FF....................F..............AAAAAAAAAAAAAAAAAAAAAAAAAAAAAAAAAAAAAAAAAAAAAAAAAAAAAAAAAAAAAAAAAAAAAAAAAAAAAAAAAAAAAAAAAAAAAAAAAAAAAAAAAAAAAAAAAAAAAAAAAAAAAAAAAAAAAAA
AAAAAAAAAAAAAAAAAAAAAAAAAAAAAAAAAAAAAAAAAAAAAAAAAAAAAAAAAAAAAAAAAAAAAAAAAAAAAAAAAAAAAAAAAAAAAAAAAAAAAAAAAAAAAA..M.........RA..A.F.................................R.AAAAAAAAAAAAAAAAAAAAAAAAAAAAAAAAAAAAAAAAAAAAAAAAAAAAAAAAAAAAAAAAAAAAAAAAAAAAAAAAAAAAAAAAAAAAAAAAAAAAAAAAAAAAAAAAAAAAAAAAAAAAAAAAAAAAAAAA
AAAAAAAAAAAAAAAAAAAAAAAAAAAAAAAAAAAAAAAAAAAAAAAAAAAAAAAAAAAAAAAAAAAAAAAAAAAAAAAAAAAAAAAAAAAAAAAAAAAAAAAAAAAAAAA.A......FFF.....F........................F..........AAAAAAAAAAAAAAAAAAAAAAAAAAAAAAAAAAAAAAAAAAAAAAAAAAAAAAAAAAAAAAAAAAAAAAAAAAAAAAAAAAAAAAAAAAAAAAAAAAAAAAAAAAAAAAAAAAAAAAAAAAAAAAAAAAAAAAAAA
AAAAAAAAAAAAAAAAAAAAAAAAAAAAAAAAAAAAAAAAAAAAAAAAAAAAAAAAAAAAAAAAAAAAAAAAAAAAAAAAAAAAAAAAAAAAAAAAAAAAAAAAAAAAAAAAAAA.A......FF...............F....FFFF...MA.AAAAAAAAAAAAAAAAAAAAAAAAAAAAAAAAAAAAAAAAAAAAAAAAAAAAAAAAAAAAAAAAAAAAAAAAAAAAAAAAAAAAAAAAAAAAAAAAAAAAAAAAAAAAAAAAAAAAAAAAAAAAAAAAAAAAAAAAAAAAAAAAA
AAAAAAAAAAAAAAAAAAAAAAAAAAAAAAAAAAAAAAAAAAAAAAAAAAAAAAAAAAAAAAAAAAAAAAAAAAAAAAAAAAAAAAAAAAAAAAAAAAAAAAAAAAAAAAAAAAAAAAAAA...R..F..................R.......AAAAAAAAAAAAAAAAAAAAAA....AAAAAAAAAAAAAAAAAAAAAAAAAAAAAAAAAAAAAAAAAAAAAAAAAAAAAAAAAAAAAAAAAAAAAAAAAAAAAAAAAAAAAAAAAAAAAAAAAAAAAAAAAAAAAAAAAAAAAAAA
AAAAAAAAAAAAAAAAAAAAAAAAAAAAAAAAAAAAAAAAAAAAAAAAAAAAAAAAAAAAAAAAAAAAAAAAAAAAAAAAAAAAAAAAAAAAAAAAAAAAAAAAAAAAAAAAAAAAAAAAAAAA....................E..AAAAAAAAAAAAAAAAAAAAAAAAAA.............AAA.........AAAAA.........AAAAAAAAAAAAAAAAAAAAAAAAAAAAAAAAAAAAAAAAAAAAAAAAAAAAAAAAAAAAAAAAAAAAAAAAAAAAAAAAAAAAAAAA
AAAAAAAAAAAAAAAAAAAAAAAAAAAAAAAAAAAAAAAAAAAAAAAAAAAAAAAAAAAAAAAAAAAAAAAAAAAAAAAAAAAAAAAAAAAAAAAAAAAAAAAAAAAAAAAAAAAAAAAAAAAAAAA...........F.....A.AAAAAAAAAAAAAAAAAAAAAAAAAA..RR.....MM....A..M....M..AAAAA..RMMM.M..AAAAAAAAAAAAAAAAAAAAAAAAAAAAAAAAAAAAAAAAAAAAAAAAAAAAAAAAAAAAAAAAAAAAAAAAAAAAAAAAAAAAAAA
AAAAAAAAAAAAAAAAAAAAAAAAAAAAAAAAAAAAAAAAAAAAAAAAAAAAAAAAAAAAAAAAAAAAAAAAAAAAAAAAAAAAAAAAAAAAAAAAAAAAAAAAAAAAAAAAAAAAAAAAAAAAAAAAAAA...RM..RR..AAAAAAAAAAAAAAAAAAAAAAAAAA...........MMDMR....A.F.....A.........MM...M.........AAAAAAAAAAAAAAAAAAAAAAAAAAAAAAAAAAAAAAAAAAAAAAAAAAAAAAAAAAAAAAAAAAAAAAAAAAAAAAA
AAAAAAAAAAAAAAAAAAAAAAAAAAAAAAAAAAAAAAAAAAAAAAAAAAAAAAAAAAAAAAAAAAAAAAAAAAAAAAAAAAAAAAAAAAAAAA......................AAAAAAAAAAAAAAAAAA..R....AAAAAAAAAAAAA...............R.M..MR..RM.........FF............MMM.....MMMM..........AAAAAAAAAAAAAAAAAAAAAAAAAAAAAAAAAAAAAAAAAAAAAAAAAAAAAAAAAAAAAAAAAAAAAAAAAAA
AAAAAAAAAAAAAAAAAAAAAAAAAAAAAAAAAAAAAAAAAAAAAAAAAAAAAAAAAAAAAAAAAAAAAAAAAAAAAAAAAAAAAAAAAA........................FR......AAAAAAAAAAAAAA..AAAAAAAAAAA...AA....................................F............M.....M.MRR......MMMRA.............AAAAAAAAAAAAAAAAAAAAAAAAAAAAAAAAAAAAAAAAAAAAAAAAAAAAAAAAAAAAAA
AAAAAAAAAAAAAAAAAAAAAAAAAAAAAAAAAAAAAAAAAAAAAAAAAAAAAAAAAAAAAAAAAAAAAAAAAAAAAAAAAAAAAAAAAA.....FFFFFF.....FF......FF.......AAAAAAAAAAAAAAAAAAAAAAAA....AAAA............................F......F.............MRM..R.....RMMMMMMMM.R.RM..MMRRR..AAAAAAAAAAAAAAAAAAAAAAAAAAAAAAAAAAAAAAAAAAAAAAAAAAAAAAAAAAAAAA
AAAAAAAAAAAAAAAAAAAAAAAAAAAAAAAAAAAAAAAAAAAAAAAAAAAAAAAAAAAAAAAAAAA..............AAAAAAAAA...F.F.FFFF.....FFFFF.FF.FF.....R....AAA......AAAAAAAAAA..RFF...AA.......F..............................................R...RMM..MMMMMMMMM.R.MMR........AAAAAAAAAAAAAAAAAAAAAAAAAAAAAAAAAAAAAAAAAAAAAAAAAAAAAAAAAA
AAAAAAAAAAAAAAAAAAAAAAAAAAAAAAAAAAAAAAAAAAAAAAAAAAAAAAAAAAAAAAAAAAA...MM....M...RAAAAAAAA..MFFFFFFFFFF....FFFFF.FFFFF.F..F...M........R..AAAAAAAAA...FFF...AA......F..........................................RM...R..M.....MM.MMMMMMMMMMMR..................AAAAAAAAAAAAAAAAAAAAAAAAAAAAAAAAAAAAAAAAAAAAAAA
AAAAAAAAAAAAAAAAAAAAAAAAAAAAAAAAAAAAAAAAAAAAAAAAAAAAAAAAAAAAAAAAAAAA....RR...RRR.AAAAAAA...F..F...F....F..FFFFFFFFFFFFFFF..............R...AAAAAAAA.....R.FFAA...........................F.F.................M...RMMMM.......RR.MMMMMMMM.RR.....R.MM.........AAAAAAAAAAAAAAAAAAAAAAAAAAAAAAAAAAAAAAAAAAAAAAA
AAAAAAAAAAAAAAAAAAAAAAAAAAAAAAAAAAAAAAAAAAAAAAAAAAAAAAAAAAAAAAAAAA....R.R....R..AAAA......F.FFF...F....R.FFFFFFFFFFFFFFFF............M....................RRAAAFFFFF...........F..F.............................RMMMM...MMMMR.RMMMMMMMMR.....RR....MMMR.......AAAAAAAAAAAAAAAAAAAAAAAAAAAAAAAAAAAAAAAAAAAAAA
AAAAAAAAAAAAAAAAAAAAAAAAAAA................AAAAAAAAAA........AAAA........RR.....AAAA.R....F....F..FF.R....FFFFFF.FFFFFFFFFFF.................M..............ARAAAR.FF.........FF.......................FFFFF......MMMMMMMMMMMMMMM.....R.......R...RMRR.R..R...AAAAAAAAAAAAAAAAAAAAAAAAAAAAAAAAAAAAAAAAAAAAAA
AAAAAAAAAAAAAAAAAAAAAAAAAA........M...M...A.AAAAAAAAA.R.....R.AA..RMMM..M.....AAAAA..F.FFFF......FFFFFRAA....FF..FF...FFFF................................M....A...F.....................FFFFF........RAR.RR.....RRRRR..R.MMMMMM.R..........M....RRR..RR.....AAA....AAAAAAAAAAAAAAAAAAAAAAAAAAAAAAAAAAAAAAAA
AAAAAAAAAAAAAAAAAAAAAAAAA.AM.....M.....................M....MAAAA..R..RM....AAAAAAAMFFFFFFF......FF.M.RAA..FF.........FFFF.....................................AA..F....................FFFFFFF.....F.AAA...............MMMMMMMR....RRRRRRR...................A.........AAAAAAAAAAAAAAAAAAAAAAAAAAAAAAAAAAAA
AAAAAAAAAAAAAAAAAAAAAAAA..M...MM.MMMMMMM...MYRR..MM....M....AAAA..R.....R...AAAAA.R.FFFFFFF..FFF.RR..AAAA..F.........FFF..F....................................RAA.....................FFFFFFFFFFFFFF.RAAARM.M.M..R......MMMMMR....M.........................AA.........AAAAAAAAAAAAAAAAAAAAAAAAAAAAAAAAAAAA
AAAAAAAAAAAAAAAAAAAA...............M......RMMWMMMM..........AAA............AAAAAAA..RR.FFFFF.MRR..AAAAAAMF...........FFFF.........................................AAM.FF..............FFFFFF..FFFFFF.RAA..MMMMMMM.R......RMM.R..........FF........M...........A....RRRAAA..AAAAAAAAAAAAAAAAAAAAAAAAAAAAAAAAA
AAAAAAAAAAAAAAAAAAAA...M.MMMM.............RM......R......AAAAAAAAAA......AAAAAAAAAA....RRRRR....AAAAA.....F..........FF.....................F....................MAA...F......MRR...FFFFFFF...FFFFFAA.A.R..MMMMMMMMM.R.....MRR..R...FFF....FF......M.................AAA..AAAAAAAAAAAAAAAAAAAAAAAAAAAAAAAAAA
AAAAAAAAAAAAAAAAAAAA..R...MM...M..MR......RRR........AAAAAAAAAAAAAAAAAAAAAAAAAAAAAAAAA...AAAAAAAAMAAA.FFFFFF...FF.MRRRR.FF..................FF....................RAA.......FF...ARR..FFFFFFFFFFF...AAA..R.MMMMMMMMM.R.MM..R..R.....FF....FF.RRM......P..........R.AAA......AAAAAAAAAAAAAAAAAAAAAAAAAAAAAAAA
AAAAAAAAAAAAAAAAA....R.MMMMM......R...AAAAA..........AAAAAAAAAAAAAAAAAAAAAAAAAAAAAAAAAAAAAAAAAAA...F....FBFFFFFF.R......RRRR....FFFF.........FF.....................A...F..F.F...AA...RR.FFFFFFFF..AA.....MMMMMMMMM..MMMMM.RR.......FFF...FFR.....................AA.........AAAAAAAAAAAAAAAAAAAAAAAAAAAAAAA
AAAAAAAAAAAAAAAAA.RMM.MMMMMM........AAAAAAAAAAAAAAAAAAAAAAAAAAAAAAAAAAAAAAAAAAAAAAAAAAAA................FFFFFFF.R.AAAAA.........MRR....F.....FMR.....MR.R...F.....RAA.....F.......AA....ARRRRRRRRAAA.RRR.RR.RRR...MM.M..M.RRRRR...................R.....RR.R....AAA.............AAAAAAAAAAAAAAAAAAAAAAAAAAAA
AAAAAAAAAAAAAAAAA..R.MMMMMMMM.....M.RAA.....AAAAAAAAAAAAAAAAAAAAAAAAAAAAAAAAAAAA.......................FFFMRRRR..AAAAAAAAAAAA..R.......FFFF.F..AAR.CMAA.....F....RAAA..............AA.............AA..R..RR.RRR.....RRRR...RRRR....M.............R.........RR..................A....AAAAAAAAAAAAAAAAAAAAAAAA
AAAAAAAAAAAAAAAAAA...R.R.R....R...R.AA..R..A.AAAAAAAAAAAAAAAAAAAAAAAAAAAAAAAAAA......M................FF.R......AAAAAAAAAAAAAA....R....FF..FFF..AARRAA..........MAAAM......F.MRRRRRAA....AAAAAAAAAAAA.........R.M..............RR..............MR..RRRR............RRRR.....RR.......AAAAAAAAAAAAAAAAAAAAAAA
AAAAAAAAAAAAAAAAAAAA...............AA.MMM.....AAAAAAAAAAAAAAAAAAAAAAAAAAAAAAA.........................FF.A.AAAAAAAAAAAAAAAAA.AAAAA...R.......FF.RAAAA...........F.AAARRRRR..MAAAAAAAAA..AAAAAAAAA...AA....R.RRR....MMMMMMMMMMM.RRR............M................AAAA................AAAAAAAAAAAAAAAAAAAAAAAAA
AAAAAAAAAAAAAAAXAAAA.............A.A..M........AAAAAAAAAAAAAAAAAAAAAAAAAAAAAA.ARRM................FFF..R...AAAAAAAAAAAAAAAA...MAAAA..........FFF..AAR...FF.....7FF.AAAAAAAARAAAAAAAAAAAAAAAAAAAAAA.......RM.R.R......RMMMMMMMM.............M.M...R......R........AAAAAAAAAAAAAAAAAAAAAA...AAAAAAAAAAAAAAAAAA
AAAAAAAAAAAAAAAAAAAA.ARRM...RRRR...A...........AAAAAAAAAAAA......AAAAAAAAAAAAA....R.FF...........FFF.M....AAAAAAAAAAAAAAAAA....MAA...........FF..AAR.....FF.........MARAAAAAAAAA.......AAA.....AAA.RRR.......R........R.R...M..............RRR.........................AAAAA...........RR....AAAAAAAAAAAAAAA
AAAAAAAAAAAAAAAAAAAAAAARARAR.R..R.AA.RRR...R..AAAAAAAAAAAA.....R..AAAAAAAAAAAAAAAA.R.FFFFFFFFF...FFFFR.AAAAAAAAAAAAAAAAAAAAA....AAM.....RM...F..AA........FF........AAAAAA.RRRRRR.M.MR.....RRR.AAAR....A.......AAAAAA........M.....................MMMMM.........R...........RR.R...........A.AAAAAAAAAAAAAA
AAAAAAAAAAAAAAAAAAAAAA.AAAAAAA....AA......A...AAAAAAAAAAA...RAARR.AAAAAAAAAAAAAAAAA..M.FFFFZFFF..FFFF....AAAAAAAAAAAAAAAAAAAA...FAAAAA.......M.AAM....FFFFFFF.....AAA.......MM.MM.8...M.MRR..RAA.RA.....AAAAAAAAAAAAAA......M.............FFF..FF......MR..R....MR...........RR..RR..MMM........AAAAAAAAAAAA
AAAAAAAAAAAAAAAAAAAAA........AAAAAAAA..R....AAAAAAAAAAAAAA..R..R.AAAAAAAAAAAAAAAAAAA......MMMMR..FFFFF...AAAAAAAAAAAAAAAAAAAAA.....AAAAAA..RR.AA9.F..FFF.MMM..R.RAAR.....RR..M............M....R....AA.AAAAAAAAAAAAAAAA..R.........MR.RR.R..FFFFFFFF.........MMMMM...RR............R.MM....R....AAAAAAAAAAAA
AAAAAAAAAAAAAAAAAAAAA......AAAAAAAAAAA......AAAAAAAAAAAAAAA.....AAAAAAAAAAAAAAAAAAAAA...........RR...M..AAAAAAAAA...AAAAAAAAAAA...AAAAAAAAA..AA...F..FF...AAAAAAAA..........M.........M..M.M.M..O.AAAAAAAAAAA......RMAAA...R......MAAAAA...M...............MMMMM.RRR.R.AAAAAAA......RM..........AAAAAAAAAAAA
AAAAAAAAAAAAAAAAAAAAAAAA...A...AAAAAAAAAAAAAAAAAAAAAAAAAAAAAAAAAAAAAAAAAAAAAAAAAAAAAAAAAAAAAAAA........AAAAAAAAAA...S...AAAAAAAAAAAAAAAAAAAAAAA.R.....M..AARRR.RRRR.RRR.M......G........MMMR.....AAAAAAAAAAA...M.......AAAA.M.AAAAAAAAAAA....F.....FFFF..F....RR....................R..R.......AAAA.....AAAA
AAAAAAAAAAAAAAAAA.....MRAAAAR.....AAAAAAAAAAAAAAAAAAAAAAAAAAAAAAAAAAAAAAAAAAAAAAAAAAAAAAAAAAAAAAAAAAAAAAAAAAA..AAAA.....AAAAAAAAAAAAAAAAAAAAAAA..RMMM.AAAA.RR........MM5..................RAAA......AAAAAAAAA.R........M..AAAA......M.RAAA...FF..FFFFFFF..MMR....AAAAAAAAAAAAAA....RRRR..RR....AAAAR.....AAA
AAAAAAAAAAA.......RR....MM.....R......AAAAAAAAAAAAAAAAAAAAAAAAAAAAAAAAAAAAAAAAAAAAAAAAAAAAAAAAAAAAAAAAAAAAAA......AA.RR.A....AAAAAAAAAAAAAAAAAAAAAAAAAAAR....M.....M.............R.R.RR..AA.MM.M.MMR.......................M.MMMMMM..M.AAA.AMMMMM.M..FF.M.....AAAAAAAAAAAAAAAAA.....RR.........AA..M..R...AA
AAAAAAAAAAA..R....RM.....MRRM..RMMR.R.......AAAAAAAAAAAAAAAAAAAAAAA.....AAAAAAAAAAAAAAAAAAAAAAAAAAAAAAAAAAAAAAARRR.AAAAAA....AAAAAAAAAAAAAMM..M.M..M.MM..MM.......MM.....MM....R.....AAAAA............MMMMMMM......FF.FFFFFF...........AAAAAAAA..AA.....A.AAAAAAAAAAAAAAAAAAAAAAA....R.........AA..RRR....AA
AAAAAAAAAAA..MMMMMM.MM....MM..RRRM.MR...................AAAAAAAAAAA..R..AAAAAAAAAAAAAAAAAAAAAAAAAAAAAAA..AAAAAAA.RR.AAAAAAQR.AAAAAAAAAA.......F.F.......M........MMMM..M....MR....RAAARAM.......................FFFF........F...FFF..MR...AAAAAAAAAA.RMAAAAAAAAAAA.....AAAAAAAAAAA...........R..AA...AA...AA
AAAAAAAAA...R.....MRRM...MMM.MRRR.....RRRRM.R.RRRR.R.R.R.........AAA...AAAAAAAAAAAAAAAAAAAAAAAAAAAAAAA....AAR6.A....AAAAA....AAAAAAAAA...MMM..........MM...................MR.AAAAAAAAAA.........................FF...FFF....F.FFFF...M..RAA...R.R.AA..AAAAAAAAAAA.AAA.AAAAAAAAAAAA........A....AAA..AAAAAAA
AAAAAAAA...RR..MM..M.MRRRR.M.R.......RRRVR...MRRR........R.....R...AA.AA...AAAAAAAAAAAAAAAAAAAAAAAAAAAA....A.R..A.AAAAAAAAAAAAAAAAAAAAA......R...........M.............RRRRRAAA........................................FF.............MMMMM..RR.MR.AAAAAAAAAAAA.AAAAAAAAAAAAAAA...................AAAAAAAAAA
AAAAAAAA.....RM.M...MRR.MRR.R.R.R.RRR..M.MM....RRR.M.....RRRRRM..RR.AAAA.R..AAAAAAAAAAAAAAAAAAAAA..AAA.....AA...AAAAAAAAAAAAAAAAAAAAAAAAAA............MMMMMMMM.........AAAAAAA.M.M.........................................................MMM..M...AAAAAAAAAAA.AAAAAA..AAAAAAA........RR...RR...R.AAAAAAAAA
AAAAAAAAA....M..M....MM..R.RRR...RM.MM.M......M.RRR.M...MM.M.M...M..AAA..R...AAAAAAAAAAAA.AAAAAA....AAA.T...A...AAAAAAAAAAAAAAAAAAAAAAAAAA..............MMMM......RRR.AARA.M.............................................................FFMR.M..RAAAAAAAAAAAAA..AAAA....AAAAAA...R.RRRRRR...RR......AAAAAAA
AAAAA.....M.....M.M..RRRRR....R.RM..MR..........MMM......M.M.M...A.AAAAR..R...AAAAAAA.......AAAA.......A..RAAAAAAAAAAAAAAAAAAAAAAAAAAAAAAA..MF................MRR...AAARAA..................................................................MM.R...AAAAAAAAAAAAA..AAAA....AAAAAA..............RRRRA.AAAAAAAA
AAAAA....MMMM..R..R.....AR.M.....R..R..AAAAAAAA.R.................AAAAAAAA....AAAA.........AAA....AA..RAA..AAAAAAAAAAAAAAAAAAAAAAAAAAAAAAA...FF.........M....M....AAAAAAA.....................................................................M...AAAAAAAAAAAAAAAAAAA....AAAAAAAAA......A....RR......AAAAAAA
AAAAA...MRRRM...RR....A....R......R....AAAAAAAAAAR.A..AAAAAAAAAAAAAAAAAAAAAAAAAA....AR......AA......RM..AA..AAAAAAAAAAAAAAAAAAAAAAAAAAAAAA..R.MMM......M..MM.AAAAAAA.M........................................................N.............M..M...AAAAAAAAAAAAAAAAAA...AAAAAAAAAAAAAAA.............AAAAAAAA
AAAAA..RM...RR..RRR.....ARR......R....AAAAAAAMAAAAAAAAAAAAAAAAAAAAA.....R..AAAA.U.......RR...A.....R.M...AAAAAAAAAAAAAAAAAAAAAAAAAAAAAAAAAA...........M4.RAAAAAAAA........M................................................................MRR.MR.AAAAAAAAAAAAAAAAAAAAAAAAAAAAAAAAAAAAA........RR...AAAAAAAA
AAAA...R.R.......RRRRR...R.R...R.....AAAAAAAAAAAAAR...AAAAAAAA..R..RRRR.MRAAAAA...RRRR.MR.R.RAA.....RMMR..AAAAAAAAAAAAAAAAAAAAAAAAAAAAAAAAAAAAAAA.........AAA..............R.................................................................R.M...AAAAAA.....AAAAAAAAAAAAAAAAAAAAAAAAA..A....RRR...AAAAAAAA
AAAAA.......R................R.R.....AAAAAAAAAA......A.........RM.RRRRR.M.R.AAARR.RRR....MM..A.A.........AAAAAAAAAAAAAAAAAAAAAAAAAAAAAAAAAAAAAAAAAAAAAAAAAARRRR.R......R......................................................................MMR..AAAAA........AAAAAAAAAAAAAAAAAAAAAAA............AAAAAAAAA
AAAAA..R...R.RRRRRRRR...........RR.............R....MR............R........AAAA..RRR.M.M....M.AA.........AAAAAAAAAAAAAAAAAAAAAAAAAAAAAAAAAAAAAAAAAAAAAAAARA...................................................................................MM.....AA..R..R....AAAAAAAAAAAAAAAAAAAAA............AAAAAAAAAA
AAAAAAA........R.RR..R.......RMMM...R....RRRR.R.....MRR....R..M.............AAA...............A.AAAAAAAAAAAAAAAAAAAAAAAAAAAAAAAAAAAAAAAAAAAAAAAAAAAAAAAAAAA.......MAAHRRR....FFFF..........................................................M.MM.R..RR.A.R........AAAAAA..AAAAAAAAAAAA.......A....AAAAAAAAAAA
AAAAAAAAAA.......RRR.RR......RR...RMM...M...........RRRRRRRR....RRRRRM....AAAAAAAAA..AA.....AAAAAAAAAAAAAAAAAAAAAAAAAAAAAAAAAAAAAAAAAAAAAAAAAAAAAAAAAAAA..........AAAM3....FFFFFFFFFF.....F....F..................L.......................MR.M..........R.R..RR..AAA.R....AAAAAAAAAAA..AA....AAAAAAAAAAAAAAA
AAAAAAAAAAAAAAAA........A..R.R.R...RM........M....R.RRRRRRR.M.MRR.....MA.AAAAAAAAAAAAAAAAAAAAAAAAAAAAAAAAAAAAAAAAAAAAAAAAAAAAAAAAAAAAAAAAAAAAAAAAAAAAAAA......M..AA.M......FFFFFFFFFFFFFFFFFFFF..........................................MR.M...R.R......R...MR....R.R...AAAAAAAAAAAAA.AAAAAAAAAAAAAAAAAAAAA
AAAAAAAAAAAAAAAAAAAAAAAAAA...............R........R.MMM...RM.MR....M....AAAAAAAAAAAAAAAAAAAAAAAAAAAAAAAAAAAAAAAAAAAAAAAAAAAAAAAAAAAAAAAAAAAAAAAAAAAAAAAAA.......AA.M.....M...FFF..FFF.FFFFFFFFFF.........................................R.M.....RRRRR.....RMM....R.R...AAAAAAAAAAAAAAAAAAAAAAAAAAAAAAAAAAAA
AAAAAAAAAAAAAAAAAAAAAAAAAAAAAA.............R..R.R.M...R....AA..........AAAAAAAAAAAAAAAAAAAAAAAAAAAAAAAAAAAAAAAAAAA...AAAAAAAAAAAAAAAAAAAAAAAAAAAAAAAAAAAAAAAAAAAA........AAAAAA....FFFFF..FF............................................MMMM.RRRAAA....................AAAAAAAAAAAA.RRRR..AAAAAAAAAAAAAAAAAA
AAAAAAAAAAAAAAAAAAAAAAAAAAAAAAAAAAAAAAA...RMM...M.R.......AAAAAAA.AAAAAAAAAAAAAAAAAAAAAAAAAAAAAAA..AAA.............RA.AAAAAAAAAAAAAAAAAAAAAAAAAAAAAAAAAAAAAAAAAAAAAAAAAAAAAAAAAAM..F...FFFF................................M.......M....R.RM....AAAAAAAAAAAA.R.R..RR..AAAAAAAAAAA..M.......AAAAAAAAAAAAAAAAA
AAAAAAAAAAAAAAAAAAAAAAAAAAAAAAAAAAAAAAA....R.M.R.........AA.RMM.AAAAAAAAAAAAAAAAAAAAAAAAAAAAAA................RRRR.F.A.AAAAAAAAAAAAAAAAAAAAAAAAAAAAAAAAAAAAAAAAAAAAAAAA..R.RRRR..FFFF.FFFF.....RRRM.............................M.R.......R......AAAAAAAAAA..........AAAAAAAAAAA.........R.RAA.......AAAAAAA
AAAAAAAAAAAAAAAAAAAAAAAAAAAAAAAAAAAAAAAAAA....M.........AAARRR..AAAAAAAAAAAAAAAAAAA..AAAAAAA..R.R..RR1..R.R...F...F.R..AAAAAAAAAAAAAAAAAAAAAAAAAAAAAAAAAAAAAAA........AAA....FFFFFFFFFF.......R........M....................MRR..RKRRRRR......AAAAAAAAAAAAAAAAAAAAAAAAAAAAAAAAA...F.........MRRRRR....AAAAAA
AAAAAAAAAAAAAAAAAAAAAAAAAAAAAAAAAAAAAAAAAAAA..R..M.M.AA..AR......AAAAAAAAAAAAAAAAA..R....AA.A......FF...............M..AAAAAAAAAAAAAAAAAAA..AAAAAAA..AAAAAA.....RRRRR.RAAA...FFFFFFF.FFFFF......R...RRR....................M.R..RRRRRRRRR.....AAAAAAAAAAAAAAAAAAAAAAAAAAAAAAAA.R..........F............AAAAA
AAAAAAAAAAAAAAAAAAAAAAAAAAAAAAAAAAAAAAAAAAAAA..........AAAA........AAAAAAAAA..AAA...F..M.A...FF...F..AA.................AAAAAAAAAA....AAA.....AAA...R..AAA..RRM..........RRRMFFFFF.................RMJ..RR.................M..R....RRR.......AAAAAAAAAAAAAAAAAAAAAAAAAAAAAAAAA............FF............AAAA
AAAAAAAAAAAAAAAAAAAAAAAAAAAAAAAAAAAAAAAAAAAAAAAAAAA...AAAAAAAAAAAAAAAAAAAAA....AA.AM.....A..R.F....AAAAA...F.............AAAAAAAA.....AAAR..R...RRR....AAA..R..........FFFFF.....................MM.MMM.R.M........MMMR..............RR.........AAAAAAAAAAAAAA.A.AAAAAAAAAAAAA..........................AAAA
AAAAAAAAAAAAAAAAAAAAAAAAAAAAAAAAAAAAAAAAAAAAAAAAAAAAAAAAAAAAAAAAAAAAAAAAAA.R..R.A.AAAAAAAAA.....AAAAAAAA.............F.A.AAAA.A...R.AAAAR..M...........AAAA........................................R.....RMMMMMM..A.............RRRRRRRRRRRRRRR.AAAAAAAAAAAA.A.......AAAAAAAAAR..........FF...F........AAAAA
AAAAAAAAAAAAAAAAAAAAAAAAAAAAAAAAAAAAAAAAAAAAAAAAAAAAAAAAAAAAA....A...AAAA.R.F.AAAAAA.....AAAAAAAAAAAAAA...............AAAAAA......M.AAA......A........AAAAAAAAAAAM.............A.R.................R..A...MMMMMR.AA...........RRRR......MMMRRR...AAAAAAAA.AA..R.....R......AAA...................AAAAAAAAAAA
AAAAAAAAAAAAAAAAAAAAAAAAAAAAAAAAAAAAAAAAAAAAAAAAAAAAAAAAAAAA.........AAA.R.FM.AAA......M..AAA.A.......AAA........AAAAAAAAAAA....R..AAAAAAAAAAAA......AAAAAAAAAAAA.............AAAA..................AARR.MM.R...AAA.RRRR.R.RRR....MMM............AAAAAAA..A.A...............AAA..............M..AAAAAAAAAAAA
AAAAAAAAAAAAAAAAAAAAAAAAAAAAAAAAAAAAAAAAAAAAAAAAAAAAAAAAAAAA.AMFF....AAA...F...AA..M......AAA....R.FF..AAAAAAAAAAAR.....AAAAAAAAAAAAAAAAAAAAAAAAAAAAAAAAAAAAAAAAAA.R........AAAAAAAAAAM..........RAAAAMM.......AAA..MM.RRR....MMM.R........AAAAAAAAAAAA....R...............RAAAAAMF....M.......AAAAAAAAAAAAA
AAAAAAAAAAAAAAAAAAAAAAAAAAAAAAAAAAAAAAAAAAAAAAAAAAAAAAAAAAAAA......RAAA..R..F.R.AA......AAA.....FF..FFF.AAAAA........F...AAAAAAAAAAAAA.........AAAAAAAAAAAAAAA..AA........R.AAAAAAAAAAA..........AAAMMMMRAAAAAAA.A..M.R....MMM.......AAAAAAAAAAAAAAAAA.M.......FF...........RAAAA.........AAAAAAAAAAAAAAAAAA
AAAAAAAAAAAAAAAAAAAAAAAAAAAAAAAAAAAAAAAAAAAAAAAAAAAAAAAAAAAAAA......AAAA........AAAAAAAAAA..............AAAA.R.......F...AAA..........F.FFFFF......AAAAAAAAAAAI2.AA.........AAAAAAAAAAAAAAAAA...AARMMMMMM..AAAAA..RMR.RMMMMR..AAAAAAAAAAAAAAAAAAAAAAAA.R.......FF........M.AAAAR.........R.AAAAAAAAAAAAAAAAA
AAAAAAAAAAAAAAAAAAAAAAAAAAAAAAAAAAAAAAAAAAAAAAAAAAAAAAAAAAAAAAAAAAAAAAAAA......AAAAAAAAAAAAAAA........RAAAAA...........AAAA.........................AAAAAAAA..R..AAR.....AAAAAAAAAAAAAAAAAAAAAAAAMMMMMMR.R.AAAA...........AAAAAAAAAAAAAAAAAAAAAAAAAAAAAA...................AAAA............AAAAAAAAAAAAAAAAA
AAAAAAAAAAAAAAAAAAAAAAAAAAAAAAAAAAAAAAAAAAAAAAAAAAAAAAAAAAAAAAAAAAAAAAAAAAAAAAAAAAAAAAAAAAAAAAA........AAAAAAAAAAAAAAAAAAAA...F....................R....AAAAA...AAAA.AAAAAAAAAAAAAAAAAAAAAAAAAAA.RMMMMR.....AAAAA.......AAAAAAA..AAAAAAAAAAAAAAAAAAAAAAAA.R.........R.AAAAAAAAAAAA..R.....AAAAAAAAAAAAAAAAAA
AAAAAAAAAAAAAAAAAAAAAAAAAAAAAAAAAAAAAAAAAAAAAAAAAAAAAAAAAAAAAAAAAAAAAAAAAAAAAAAAAAAAAAAAAAAAAAAAAAAAAAAAAAAAAAAAAAAAAAAAAAAA..MF..........................AAAAAAAAAAAAAAAAAAAAAAAAAAAAAAAAAAAAAAA.MMMR..AAAAAAAAAA.AAAAAAAAAAA....R..A.A.AAAAAAAAAA.AAAAA.....F.......AAAAAAAAAAA.........AAAAAAAAAAAAAAAAAA
AAAAAAAAAAAAAAAAAAAAAAAAAAAAAAAAAAAAAAAAAAAAAAAAAAAAAAAAAAAAAAAAAAAAAAAAAAAAAAAAAAAAAAAAAAAAAAAAAAAAAAAAAAAAAAAAAAAAAAAAAAAAA.......FF........................AAAAAAAAAAAAAAAAAAAAAAAAAAAAAAAAAA.R.R...AAAAAAAAAAAAAAAAA......R...FF.M....AAAAAAAAA..A.RMM...F...AA..AAAAAA...............AAAAAAAAAAAAAAAAAA
AAAAAAAAAAAAAAAAAAAAAAAAAAAAAAAAAAAAAAAAAAAAAAAAAAAAAAAAAAAAAAAAAAAAAAAAAAAAAAAAAAAAAAAAAAAAAAAAAAAAAAAAAAAAAAAAAAAAAAAAAAAAAA.......................R.....F..AAA.A..AAAAAAAAAAAAAAAAAAAAAAAAAAAA.A....AAA.....A........R.FF.....FFF..FF.RAAAAAAAAAA...M...FF..R..AAAAAAAA.AM.......A.A..AAAAAAAAAAAAAAAAAAA
AAAAAAAAAAAAAAAAAAAAAAAAAAAAAAAAAAAAAAAAAAAAAAAAAAAAAAAAAAAAAAAAAAAAAAAAAAAAAAAAAAAAAAAAAAAAAAAAAAAAAAAAAAAAAAAAAAAAAAAAAAAAAAAAAA...........AAAAAAAA.....F..AAA.......AAAAAAAAAAAA.......AAAAAAAAAAAAAAAR..........M................F..AAAAAAA..R.............R..AAAAAAA..M........AAAAAAAAAAAAAAAAAAAAAAAA
AAAAAAAAAAAAAAAAAAAAAAAAAAAAAAAAAAAAAAAAAAAAAAAAAAAAAAAAAAAAAAAAAAAAAAAAAAAAAAAAAAAAAAAAAAAAAAAAAAAAAA......AAA.A.........AAAAAAAAAAAAAAAAAAAA....AAAAA.....AAAA..MF.M..AA....AAAA.R..R.M.MAAR...AAAAAAAA.M............................AAAA.....M.......AAAA.A.A..AAAAAAA..A.A.AAAA.AAAAAAAAAAAAAAAAAAAAAAAA
AAAAAAAAAAAAAAAAAAAAAAAAAAAAAAAAAAAAAAAAAAAAAAAAAAAAAAAAAAAAAAAAAAAAAAAAAAAAAAAAAAAAAAAAAAAAAAAA.A....R.FF.R.....FF.....F...A.AAAAAAAAAAAAAA....MA.AAAAA...AAAAA..M..R..AA.F.MAAAA....FFFFMAA..FF....AAAAA...................RAAAAA.AAAAAA.RAAAA.A.AA..AAAAAAAAAAAAAAAAAAAAAAAAAAAAAAAAAAAAAAAAAAAAAAAAAAAAA
AAAAAAAAAAAAAAAAAAAAAAAAAAAAAAAAAAAAAAAAAAAAAAAAAAAAAAAAAAAAAAAAAAAAAAAAAAAAAAAAAAAAAAAAAAAA....R........FFF......FF...FFFFF.....AAAAAAAAAA.AMF.....AAAAAAAAAA......FM.AAAAAAAAAAM.....FFR.AA....F....RAAAAAAAAA...........AAAAAAAAAAAAAAM....AAAAAAAAAAAAAAAAAAAAAAAAAAAAAAAAAAAAAAAAAAAAAAAAAAAAAAAAAAAAAA
AAAAAAAAAAAAAAAAAAAAAAAAAAAAAAAAAAAAAAAAAAAAAAAAAAAAAAAAAAAAAAAAAAAAAAAAAAAAAAAAAAAAAAAAAAA..MFFF....0....F........FF.....FFFFF.R.AAAAAAAAA....RAA..AAAAAAAAA.R.FFFFF.AAAAAAA.............AAAA..........AAAAAAAA..........R.AAAAAAAAAAAA..A...AAAAAAAAAAAAAAAAAAAAAAAAAAAAAAAAAAAAAAAAAAAAAAAAAAAAAAAAAAAAAA
AAAAAAAAAAAAAAAAAAAAAAAAAAAAAAAAAAAAAAAAAAAAAAAAAAAAAAAAAAAAAAAAAAAAAAAAAAAAAAAAAAAAAAAA....MF..................................F...A.AAAAAAA.A.....AAAAAAAAAA.AAAAA.AAAAAAAAAA.M..............M.......RAAAAAAAAA..AAAAAAAAAAAAAAAAAAAAAAAAAAAAAAAAAAAAAAAAAAAAAAAAAAAAAAAAAAAAAAAAAAAAAAAAAAAAAAAAAAAAAAAAA
AAAAAAAAAAAAAAAAAAAAAAAAAAAAAAAAAAAAAAAAAAAAAAAAAAAAAAAAAAAAAAAAAAAAAAAAAAAAAAAAAAAAAA..R........................F...............FFF...AAAAAAAA.R....AAAAAAAAAAAAAAAAAAAAAAAAAA.............M...........AAAAAAAAAAAAAAAAAAAAAAAAAAAAAAAAAAAAAAAAAAAAAAAAAAAAAAAAAAAAAAAAAAAAAAAAAAAAAAAAAAAAAAAAAAAAAAAAAAAA
AAAAAAAAAAAAAAAAAAAAAAAAAAAAAAAAAAAAAAAAAAAAAAAAAAAAAAAAAAAAAAAAAAAAAAAAAAAAAAAAAAAAA..R............................F.............FFF...AAAAAA.R.....AAAAAAAAAAAAAAAAAAAAAAAAAAA...A....A.AA.....A.AAA.AAAAAAAAAAAAAAAAAAAAAAAAAAAAAAAAAAAAAAAAAAAAAAAAAAAAAAAAAAAAAAAAAAAAAAAAAAAAAAAAAAAAAAAAAAAAAAAAAAAAA
AAAAAAAAAAAAAAAAAAAAAAAAAAAAAAAAAAAAAAAAAAAAAAAAAAAAAAAAAAAAAAAAAAAAAAAAAAAAAAAAAAAA..R.................FF.F......F................FFF.R.........M..AAAAAAAAAAAAAAAAAAAAAAAAAAAAAAAAAAAAAAAAAAAAAAAAAAAAAAAAAAAAAAAAAAAAAAAAAAAAAAAAAAAAAAAAAAAAAAAAAAAAAAAAAAAAAAAAAAAAAAAAAAAAAAAAAAAAAAAAAAAAAAAAAAAAAAAA
AAAAAAAAAAAAAAAAAAAAAAAAAAAAAAAAAAAAAAAAAAAAAAAAAAAAAAAAAAAAAAAAAAAAAAAAAAAAAAAAAAA.................RAAA.MF........................................AAAAAAAAAAAAAAAAAAAAAAAAAAAAAAAAAAAAAAAAAAAAAAAAAAAAAAAAAAAAAAAAAAAAAAAAAAAAAAAAAAAAAAAAAAAAAAAAAAAAAAAAAAAAAAAAAAAAAAAAAAAAAAAAAAAAAAAAAAAAAAAAAAAAAAAAA
AAAAAAAAAAAAAAAAAAAAAAAAAAAAAAAAAAAAAAAAAAAAAAAAAAAAAAAAAAAAAAAAAAAAAAAAAAAAAAAAAAA.....F.......FFFF....AMF..F...............F.FF....FFFFFFFFFFFR.AAAAAAAAAAAAAAAAAAAAAAAAAAAAAAAAAAAAAAAAAAAAAAAAAAAAAAAAAAAAAAAAAAAAAAAAAAAAAAAAAAAAAAAAAAAAAAAAAAAAAAAAAAAAAAAAAAAAAAAAAAAAAAAAAAAAAAAAAAAAAAAAAAAAAAAAAA
